20 20
3 3
1 1 3 3 3 3 3 3 3 3 3 3 3 3 3 3 3 3 3 3
1 4 4 4 4 4 4 4 4 4 4 4 4 4 4 4 4 4 4 3
3 4 4 4 4 4 4 4 4 4 4 4 4 4 4 4 4 4 4 3
3 4 4 4 4 4 4 4 4 4 4 4 4 4 4 4 4 4 4 3
3 4 4 4 4 4 4 4 4 4 4 4 4 4 4 4 4 4 4 3
2 1 1 1 1 1 1 1 1 1 1 1 1 1 1 1 1 1 1 3
2 1 1 1 1 1 1 1 1 1 1 1 1 1 1 1 1 1 1 3
2 1 1 1 1 1 1 1 1 1 1 1 1 1 1 1 1 1 1 3
2 1 1 1 1 1 1 1 1 1 1 1 1 1 1 1 1 1 1 3
2 1 1 1 1 1 1 1 1 1 1 1 1 1 1 1 1 1 1 3
2 1 1 1 1 1 1 2 1 2 1 1 1 1 1 1 1 1 1 2
2 1 1 1 1 1 1 1 1 1 1 1 1 1 1 1 1 1 1 2
2 1 1 1 1 1 1 1 1 1 1 1 1 1 1 1 1 1 1 2
2 1 1 1 1 1 1 1 1 1 1 1 1 1 1 1 1 1 1 2
2 1 1 1 1 1 1 1 1 1 1 1 1 1 1 1 1 1 1 2
2 1 0 0 0 0 0 0 0 0 0 0 0 0 0 0 0 0 1 2
2 1 0 0 0 0 0 0 0 0 0 0 0 0 0 0 0 0 1 2
2 1 0 0 0 0 0 0 0 0 0 0 0 0 0 0 0 0 1 2
2 1 0 0 0 0 0 0 0 0 0 0 0 0 0 0 0 0 1 2
2 2 2 2 2 2 2 2 2 2 2 2 2 2 2 2 2 2 2 2